111111111111111111111111111111
100000000000100000000001111001
111110100111101111111100000001
110010100101101101000111111101
110010100101000101000000000001
110110100101010101011111101101
100000000000010101010000000011
101111100100011000110111110111
110000001011000001100000010$01
111111111111111111111111111111