11111111111111111111111111111111111111111111111111
1000000000011111000000000000000000000001000@000001
11111011110000000111110111111101000000010000001001
10001000000111111000000000000101000000010011001001
10001111110111111001101000000101000000010011001001
10000000010000000001101000000101111111110011001001
10000000011100111111101111111100000000000011001001
10111111000010100000100000001111111111111111001001
10000000100010100100111111100010000000000000001001
10111110100010100100000000101010111111111111101001
10100010111110100111100000111010000000000000001001
10100010000000100000010000001010111111110101101001
10100011111111111111001000001010000000010101101001
10110000000000000001001000001011111111010101101001
10000011110011111001001100001000000000010101101001
11101010001010001001000100001111111011110101101001
11100001011111000100100110000010000000000101101001
11011010100110001001000000000010111111111101101001
10001011101110101001000111111010000000000101101001
10001100000000101001001000001010000000000100001001
10100100111111101100111011101011111000000111101001
10100101000000000101101011101000000000000000001001
10010101000000000100001001101000000000000000001001
100101010000011111111010010011111110001111111110&1
10010101000001000000101001010000001000100000001001
10010101000001011110101001010010101000101111101001
10010001000001010010100001010010101111100000101001
10010101111111010010111111010010100000011110101001
10011101$00000010010000000010100111111000000100001
11111111111111111111111111111111111111111111111111