11111111111111111111111111111111111111111111111111
10000000000111110000000000000000000000010000000001
11111011110000000111110111111101000000010000001001
10001000000111111000000000000101000000010011001001
10001111110111111001101000000101000000010011001001
10000000010000000001101000000101111111110011001001
10000000011100111111101111111100000000000011001001
10111111000010100000100000001111111111111111001001
10000000100010100000111111100000000000000000001001
10111110100010100000000000101000000000000000001001
10100010111110100000000000111000000000000000001001
10100010000000100000000000000000000000000000001001
10100011111111101111000000000000000000000000001001
10110000000000000001000000000000000000000000001001
10000011110011111001000000000000000000000000001001
11101010001010001001000000000000000000000000001001
1000o001011111000100100000000000000000000000001001
10000010100100001001000000000000000000000000001001
10000011100000001001000111111000000000000000001001
10000000000000001001001000001000000000000000001001
10000000000000001100111011101000000000000000001001
10000000000000000101101011101000000000000000001001
10000000000000000100001001101000000000000000001001
10000000000001111111101001001111111000111111111001
10000000000001000000101001010000001000100000001001
10000000000001011110101001010010101000101111101001
10000000000001010010100001010010101111100000101001
10000001111111010010111111010010100000011110101001
10000001$00000010010000000010100111111000000100001
11111111111111111111111111111111111111111111111111